+-+-+-+-+-+-+-+-+-+
S         |       |
+ +-+-+-+ +-+-+ + +
| |       |   | | |
+-+ +-+-+-+ + + + +
|   |   |   | | | |
+ +-+ + + +-+ +-+ +
| |   |   |   |   |
+ + +-+ +-+ +-+ +-+
|     | |   |     |
+-+-+-+ + +-+ + +-+
| |   | |     |   |
+ + + + +-+-+-+-+ +
|   |   | |   |   |
+ +-+-+-+ + +-+ + +
|         | |   | |
+-+-+ +-+-+ + +-+ +
|     |       |   E
+-+-+-+-+-+-+-+-+-+