+-+-+-+-+-+-+-+-+-+-+-+
S   |     |       |   |
+-+ + +-+ +-+ + + +-+ +
|   | | |     | |   | |
+ +-+ + +-+-+-+-+ + + +
| |   |         | |   |
+ + +-+-+-+-+-+ + +-+-+
|       |         |   |
+ +-+ +-+ +-+-+-+-+ + +
|   | |   |       | | |
+-+ + + +-+ +-+ + + + +
| | | |   |   | |   | |
+ + + +-+ +-+ +-+-+-+ +
| | |   | | |     |   |
+ + +-+ + + +-+-+ +-+-+
| | |   | | |         |
+ + + +-+ + +-+-+-+-+ +
|   |   |     |       |
+ +-+-+ +-+-+ + +-+-+-+
|   | | |     |       |
+-+ + + + + +-+-+-+ + +
|   |   | |         | E
+-+-+-+-+-+-+-+-+-+-+-+