+-+-+-+-+-+-+-+-+-+-+-+-+-+
S   |   |     |     |     |
+-+ + + + +-+ + + + + + + +
|   | | | |   | | |   | | |
+ +-+-+ + +-+-+ + +-+-+ + +
|       |   |   |   | | | |
+ +-+-+-+-+ + +-+ + + +-+ +
| |         |   | | |     |
+ + +-+-+-+-+-+ + + + +-+-+
| |         |   | | |     |
+ +-+ +-+-+ + +-+-+ + +-+ +
| |   |       |     |   | |
+ + +-+ +-+-+-+ +-+-+-+-+ +
|   |   |   |   |         |
+-+-+ +-+ + + +-+-+ +-+-+-+
|     |E| |   |     |     |
+ +-+-+ + +-+-+ +-+ + + + +
|     |     | | |   | | | |
+-+ + +-+ + + + + +-+ + + +
|   |     |   | | |   | | |
+ +-+-+-+-+ +-+ + + +-+ + +
|     |     |   | | |   | |
+ +-+ + +-+ + +-+ +-+ +-+ +
| |   | |   |   |     |   |
+ +-+-+ + +-+ + +-+-+-+ +-+
|       |     |           |
+-+-+-+-+-+-+-+-+-+-+-+-+-+